WWWWWWWWWWWWWWWWWWWWW
W..1.......2........W
W..1................W
W..1...1..1...3223..W
W..1...1..1...2..3.1W
W..1...1..1........1W
W..11111..1111111111W
W..1.......2........W
W..1................W
W..1...1..1...3223..W
W..1...1..1...2..3.1W
W..1...1..1........1W
W..11111..1111111111W
W...................W
W...................W
W...................W
W...................W
WWWWWWWWWWWWWWWWWWWWW
